1111101111101111111110111
0100101010001010000010101
1111101011101011111011101
0000100000101000001000001
1111101111101011101011111
1000001000101010101010000
1110111010101010111010111
0010101010100010000010001
1010101011101110111011111
1010001010001000101000001
1011111011111011101111101
1000000000000010000010001
1111111110111111111010111
1000100000100000001000100
1110101110111011101111101
1000101010001010100000001
1110101010111010101110111
0010101010100010101010101
1110111011111110111011111
0000000000000000000000000
