101111101110101111111011111110
111000101010101000101000000010
101011111010111011101110111010
101010001010000010000010101010
101010111011111110111011101010
101010000000000000001000101010
101011111011101111101011101010
101000001010101000101000001010
101011101010111010111011101110
100010101010000010001010101000
111010111010111111111110101010
001010000010100000000000001010
101011101010111011101111111110
101000101010001010101000000010
101111101011101110101011111010
100000001010100000101000001000
111110111110101110101110111110
001010000010100010100010000010
111011111010101110111011111010
100000001000101000100000001010
111111101111101111101111101110
100000100000000000001000100010
111110111111111111111110111110