11101111111110111010111011111011111011111110111110101111111110
01100000001010101010101010001000001010000010100010101000000010
10111011111011101110101110101111111110111010101010111011101110
10001000001000100000100000101000000000101010101010100010101000
11101110111011101110101111101011101111101110101010101110101010
10000010100000001000101000001000101000000000101010100010001010
11111110111110111110111011111011101111101111101110111010111010
10000000000010100010001010000010000000100010000010001010101010
11111111111011111011111011101011111110101110111010111011101010
00000000001010000000001010101010001010101000101010100000001010
11101110101011101111101010111011101010111010101010101011101010
10101010101000101000100010000000101000000010101010101010101010                                                                                                   0
10101010111010101110101110111011101111111110101110101110111010
10101000100010100010101000101000100010000000100000100000100010
10111110111011101110101111101011101011111111101111111110111110
10000010001000101000100000001010001000000000000010000010000000
11111010101110101011111111101010111111111011111010111111111110
00000010100010001000000010101010000000101000101010100010000000
11111111111011101111111010111010111111101110101110101110111110
10000000000000100010001000000010100000000010100000100010100010
11111111111110111011101011111110111010111110101110111011101110
10000000001000001000001010000000001010100000001010001000001000
11111111101111111111111011111111111011111111111011111011111110
00000000000000000000000000000000000000000000000000000000000000
